101111111111111
100110111100011
100111110110011
100101111001101
110000100011111
111010011111101
101110001011111
100101000000101
100010111000001
111001111011001
111000101101011
111000101110011
100011110000111
101110011010111
110111111100101
111011110000011
111100011011101
111000110011101
110000001011011
101100010011011
110101111010101
110110110000101
110110100010011
110110010000001
100111100101011
110011110000101
101010100111011
101111010100001
110100000000101
111110111111111
